1111111111111111
10000001C0000111
1111000100001001
1P0000C0000010C1
1111111111111111
