1110111111111111
1E000001C0000001
1111000100001001
1P000000000010C1
1111111111111111
