1111111111111111
1E000001C0000111
1111000100000001
1000000000000001
1000000100001001
1000000100001001
1P0000C1000010C1
1111111111111111
