11111111
1E000001
10110001
1C000001
1P000001
11111111
