1111111111111111
1E00000100C00111
1011000100000001
1C000000000000C1
1P00000100C01001
1111111111111111
