111111111111111111111111111111
100000000000000000000000000001
10000000000000000000000000E001
100000000000000000000000000001
100000000000000000000000C00001
100000000011110000111100000001
100000000010010000100100000001
10000000001P010000100100000001
100000000100001001000010000001
100000000100001001000010000001
100000000100001001000010000001
100000001000000110000001000001
100000001000000110000001000001
100000001000000110000001000001
100000000000000000000000000001
111111111111111111111111111111
