111111111111111111111111111111
100000000000000000000000000001
1000C100000000010000000000E001
111111000000111100000000000001
100000000000100000000000C10001
100001111111100001111000110001
100000000100100001C01000100001
100C000001P0100001001000100001
100000001000010010000111100001
100011111000010010000100000001
100010001000010010000100000001
10111001000C001100000011111001
100000010000001100000010000001
10010001000000110000001C000001
100100000000001100000000000001
111111111111111111111111111111
