111111111111
1E0000000001
111111101001
1P00000010C1
111111111111
