111111111111
1E0C000C00C1
111111101001
1P00000010C1
111111111111
